D395795393
96A95696AA
C3C2D3C56A
BAFC3AFFFA
AAFD4057FA
86FFFAFFFA
A953FAFD52
AC7AFAFFFA
C552D69552
D554556D56

0,0
9,9
