BD1553D393
C3AD5456AA
BAC539556A
AAF96AFFFA
AAFC5057FA
AAFFFAFFFA
86D3FAFD52
C392FAFFFA
BC6C3C793A
C5554556C6

0,0
9,9
SESSSSSWSESENESESEEENESE
