9395553953
EAAD156ABA
96C3A9546A
ABFAEAFFFA
AAFC5057FA
AAFFFAFFFA
AC17FAFD52
C3C3FAFFFA
9692D693D2
C56C556C56

0,1
1,0
NE
